bbc1	bbc1
bbc2	bbc2
itv1	itv1
ch4	ch4
five	five
bbc1_scotland	bbc1_scotland
bbc1_wales	bbc1_wales
bbc3	bbc3
bbc4	bbc4
bbc7	bbc7
bbc_6music	bbc_6music
bbc_news24	bbc_news24
bbc_radio1	bbc_radio1
bbc_radio1_xtra	bbc_radio1_xtra
bbc_radio2	bbc_radio2
bbc_radio3	bbc_radio3
bbc_radio4	bbc_radio4
bbc_radio5_live	bbc_radio5_live
bbc_radio5_live_sports_extra	bbc_radio5_live_sports_extra
boomerang	boomerang
bravo	bravo
british_eurosport	british_eurosport
cartoon_network	cartoon_network
cbbc	cbbc
cbeebies	cbeebies
challenge	challenge
discovery	discovery
disney	disney
e4	e4
film_four	film_four
ftn	ftn
itv2	itv2
men_and_motors	men_and_motors
mtv	mtv
nick_junior	nick_junior
nickelodeon	nickelodeon
oneword	oneword
paramount	paramount
paramount2	paramount2
scifi	scifi
sky_movies1	sky_movies1
sky_movies2	sky_movies2
sky_movies3	sky_movies3
sky_movies4	sky_movies4
sky_movies5	sky_movies5
sky_movies6	sky_movies6
sky_movies7	sky_movies7
sky_movies8	sky_movies8
sky_movies9	sky_movies9
sky_movies_cinema	sky_movies_cinema
sky_movies_cinema2	sky_movies_cinema2
sky_one	sky_one
sky_one_mix	sky_one_mix
sky_sports1	sky_sports1
sky_sports2	sky_sports2
sky_sports3	sky_sports3
sky_sports_xtra	sky_sports_xtra
tcm	tcm
uk_bright_ideas	uk_bright_ideas
uk_drama	uk_drama
uk_gold	uk_gold
uk_gold2	uk_gold2
uk_history	uk_history
uk_horizons	uk_horizons
uk_style	uk_style
vh1	vh1
